####s#####
##       #
## ## ## #
## ## ## #
##### ## #
#     ## #
#f###### #
